/projects/piml_inversion/FWIOpenData/CurveFault_A/seis2_1_0.npy	/projects/piml_inversion/FWIOpenData/CurveFault_A/vel2_1_0.npy
/projects/piml_inversion/FWIOpenData/CurveFault_A/seis2_1_1.npy	/projects/piml_inversion/FWIOpenData/CurveFault_A/vel2_1_1.npy
/projects/piml_inversion/FWIOpenData/CurveFault_A/seis2_1_2.npy	/projects/piml_inversion/FWIOpenData/CurveFault_A/vel2_1_2.npy
/projects/piml_inversion/FWIOpenData/CurveFault_A/seis2_1_3.npy	/projects/piml_inversion/FWIOpenData/CurveFault_A/vel2_1_3.npy
/projects/piml_inversion/FWIOpenData/CurveFault_A/seis2_1_4.npy	/projects/piml_inversion/FWIOpenData/CurveFault_A/vel2_1_4.npy
/projects/piml_inversion/FWIOpenData/CurveFault_A/seis2_1_5.npy	/projects/piml_inversion/FWIOpenData/CurveFault_A/vel2_1_5.npy
/projects/piml_inversion/FWIOpenData/CurveFault_A/seis2_1_6.npy	/projects/piml_inversion/FWIOpenData/CurveFault_A/vel2_1_6.npy
/projects/piml_inversion/FWIOpenData/CurveFault_A/seis2_1_7.npy	/projects/piml_inversion/FWIOpenData/CurveFault_A/vel2_1_7.npy
/projects/piml_inversion/FWIOpenData/CurveFault_A/seis2_1_8.npy	/projects/piml_inversion/FWIOpenData/CurveFault_A/vel2_1_8.npy
/projects/piml_inversion/FWIOpenData/CurveFault_A/seis2_1_9.npy	/projects/piml_inversion/FWIOpenData/CurveFault_A/vel2_1_9.npy
/projects/piml_inversion/FWIOpenData/CurveFault_A/seis2_1_10.npy	/projects/piml_inversion/FWIOpenData/CurveFault_A/vel2_1_10.npy
/projects/piml_inversion/FWIOpenData/CurveFault_A/seis2_1_11.npy	/projects/piml_inversion/FWIOpenData/CurveFault_A/vel2_1_11.npy
/projects/piml_inversion/FWIOpenData/CurveFault_A/seis2_1_12.npy	/projects/piml_inversion/FWIOpenData/CurveFault_A/vel2_1_12.npy
/projects/piml_inversion/FWIOpenData/CurveFault_A/seis2_1_13.npy	/projects/piml_inversion/FWIOpenData/CurveFault_A/vel2_1_13.npy
/projects/piml_inversion/FWIOpenData/CurveFault_A/seis2_1_14.npy	/projects/piml_inversion/FWIOpenData/CurveFault_A/vel2_1_14.npy
/projects/piml_inversion/FWIOpenData/CurveFault_A/seis2_1_15.npy	/projects/piml_inversion/FWIOpenData/CurveFault_A/vel2_1_15.npy
/projects/piml_inversion/FWIOpenData/CurveFault_A/seis2_1_16.npy	/projects/piml_inversion/FWIOpenData/CurveFault_A/vel2_1_16.npy
/projects/piml_inversion/FWIOpenData/CurveFault_A/seis2_1_17.npy	/projects/piml_inversion/FWIOpenData/CurveFault_A/vel2_1_17.npy
/projects/piml_inversion/FWIOpenData/CurveFault_A/seis2_1_18.npy	/projects/piml_inversion/FWIOpenData/CurveFault_A/vel2_1_18.npy
/projects/piml_inversion/FWIOpenData/CurveFault_A/seis2_1_19.npy	/projects/piml_inversion/FWIOpenData/CurveFault_A/vel2_1_19.npy
/projects/piml_inversion/FWIOpenData/CurveFault_A/seis2_1_20.npy	/projects/piml_inversion/FWIOpenData/CurveFault_A/vel2_1_20.npy
/projects/piml_inversion/FWIOpenData/CurveFault_A/seis2_1_21.npy	/projects/piml_inversion/FWIOpenData/CurveFault_A/vel2_1_21.npy
/projects/piml_inversion/FWIOpenData/CurveFault_A/seis2_1_22.npy	/projects/piml_inversion/FWIOpenData/CurveFault_A/vel2_1_22.npy
/projects/piml_inversion/FWIOpenData/CurveFault_A/seis2_1_23.npy	/projects/piml_inversion/FWIOpenData/CurveFault_A/vel2_1_23.npy
/projects/piml_inversion/FWIOpenData/CurveFault_A/seis2_1_24.npy	/projects/piml_inversion/FWIOpenData/CurveFault_A/vel2_1_24.npy
/projects/piml_inversion/FWIOpenData/CurveFault_A/seis2_1_25.npy	/projects/piml_inversion/FWIOpenData/CurveFault_A/vel2_1_25.npy
/projects/piml_inversion/FWIOpenData/CurveFault_A/seis2_1_26.npy	/projects/piml_inversion/FWIOpenData/CurveFault_A/vel2_1_26.npy
/projects/piml_inversion/FWIOpenData/CurveFault_A/seis2_1_27.npy	/projects/piml_inversion/FWIOpenData/CurveFault_A/vel2_1_27.npy
/projects/piml_inversion/FWIOpenData/CurveFault_A/seis2_1_28.npy	/projects/piml_inversion/FWIOpenData/CurveFault_A/vel2_1_28.npy
/projects/piml_inversion/FWIOpenData/CurveFault_A/seis2_1_29.npy	/projects/piml_inversion/FWIOpenData/CurveFault_A/vel2_1_29.npy
/projects/piml_inversion/FWIOpenData/CurveFault_A/seis2_1_30.npy	/projects/piml_inversion/FWIOpenData/CurveFault_A/vel2_1_30.npy
/projects/piml_inversion/FWIOpenData/CurveFault_A/seis2_1_31.npy	/projects/piml_inversion/FWIOpenData/CurveFault_A/vel2_1_31.npy
/projects/piml_inversion/FWIOpenData/CurveFault_A/seis3_1_0.npy	/projects/piml_inversion/FWIOpenData/CurveFault_A/vel3_1_0.npy
/projects/piml_inversion/FWIOpenData/CurveFault_A/seis3_1_1.npy	/projects/piml_inversion/FWIOpenData/CurveFault_A/vel3_1_1.npy
/projects/piml_inversion/FWIOpenData/CurveFault_A/seis3_1_2.npy	/projects/piml_inversion/FWIOpenData/CurveFault_A/vel3_1_2.npy
/projects/piml_inversion/FWIOpenData/CurveFault_A/seis3_1_3.npy	/projects/piml_inversion/FWIOpenData/CurveFault_A/vel3_1_3.npy
/projects/piml_inversion/FWIOpenData/CurveFault_A/seis3_1_4.npy	/projects/piml_inversion/FWIOpenData/CurveFault_A/vel3_1_4.npy
/projects/piml_inversion/FWIOpenData/CurveFault_A/seis3_1_5.npy	/projects/piml_inversion/FWIOpenData/CurveFault_A/vel3_1_5.npy
/projects/piml_inversion/FWIOpenData/CurveFault_A/seis3_1_6.npy	/projects/piml_inversion/FWIOpenData/CurveFault_A/vel3_1_6.npy
/projects/piml_inversion/FWIOpenData/CurveFault_A/seis3_1_7.npy	/projects/piml_inversion/FWIOpenData/CurveFault_A/vel3_1_7.npy
/projects/piml_inversion/FWIOpenData/CurveFault_A/seis3_1_8.npy	/projects/piml_inversion/FWIOpenData/CurveFault_A/vel3_1_8.npy
/projects/piml_inversion/FWIOpenData/CurveFault_A/seis3_1_9.npy	/projects/piml_inversion/FWIOpenData/CurveFault_A/vel3_1_9.npy
/projects/piml_inversion/FWIOpenData/CurveFault_A/seis3_1_10.npy	/projects/piml_inversion/FWIOpenData/CurveFault_A/vel3_1_10.npy
/projects/piml_inversion/FWIOpenData/CurveFault_A/seis3_1_11.npy	/projects/piml_inversion/FWIOpenData/CurveFault_A/vel3_1_11.npy
/projects/piml_inversion/FWIOpenData/CurveFault_A/seis3_1_12.npy	/projects/piml_inversion/FWIOpenData/CurveFault_A/vel3_1_12.npy
/projects/piml_inversion/FWIOpenData/CurveFault_A/seis3_1_13.npy	/projects/piml_inversion/FWIOpenData/CurveFault_A/vel3_1_13.npy
/projects/piml_inversion/FWIOpenData/CurveFault_A/seis3_1_14.npy	/projects/piml_inversion/FWIOpenData/CurveFault_A/vel3_1_14.npy
/projects/piml_inversion/FWIOpenData/CurveFault_A/seis3_1_15.npy	/projects/piml_inversion/FWIOpenData/CurveFault_A/vel3_1_15.npy
/projects/piml_inversion/FWIOpenData/CurveFault_A/seis3_1_16.npy	/projects/piml_inversion/FWIOpenData/CurveFault_A/vel3_1_16.npy
/projects/piml_inversion/FWIOpenData/CurveFault_A/seis3_1_17.npy	/projects/piml_inversion/FWIOpenData/CurveFault_A/vel3_1_17.npy
/projects/piml_inversion/FWIOpenData/CurveFault_A/seis3_1_18.npy	/projects/piml_inversion/FWIOpenData/CurveFault_A/vel3_1_18.npy
/projects/piml_inversion/FWIOpenData/CurveFault_A/seis3_1_19.npy	/projects/piml_inversion/FWIOpenData/CurveFault_A/vel3_1_19.npy
/projects/piml_inversion/FWIOpenData/CurveFault_A/seis3_1_20.npy	/projects/piml_inversion/FWIOpenData/CurveFault_A/vel3_1_20.npy
/projects/piml_inversion/FWIOpenData/CurveFault_A/seis3_1_21.npy	/projects/piml_inversion/FWIOpenData/CurveFault_A/vel3_1_21.npy
/projects/piml_inversion/FWIOpenData/CurveFault_A/seis3_1_22.npy	/projects/piml_inversion/FWIOpenData/CurveFault_A/vel3_1_22.npy
/projects/piml_inversion/FWIOpenData/CurveFault_A/seis3_1_23.npy	/projects/piml_inversion/FWIOpenData/CurveFault_A/vel3_1_23.npy
/projects/piml_inversion/FWIOpenData/CurveFault_A/seis3_1_24.npy	/projects/piml_inversion/FWIOpenData/CurveFault_A/vel3_1_24.npy
/projects/piml_inversion/FWIOpenData/CurveFault_A/seis3_1_25.npy	/projects/piml_inversion/FWIOpenData/CurveFault_A/vel3_1_25.npy
/projects/piml_inversion/FWIOpenData/CurveFault_A/seis3_1_26.npy	/projects/piml_inversion/FWIOpenData/CurveFault_A/vel3_1_26.npy
/projects/piml_inversion/FWIOpenData/CurveFault_A/seis3_1_27.npy	/projects/piml_inversion/FWIOpenData/CurveFault_A/vel3_1_27.npy
/projects/piml_inversion/FWIOpenData/CurveFault_A/seis3_1_28.npy	/projects/piml_inversion/FWIOpenData/CurveFault_A/vel3_1_28.npy
/projects/piml_inversion/FWIOpenData/CurveFault_A/seis3_1_29.npy	/projects/piml_inversion/FWIOpenData/CurveFault_A/vel3_1_29.npy
/projects/piml_inversion/FWIOpenData/CurveFault_A/seis3_1_30.npy	/projects/piml_inversion/FWIOpenData/CurveFault_A/vel3_1_30.npy
/projects/piml_inversion/FWIOpenData/CurveFault_A/seis3_1_31.npy	/projects/piml_inversion/FWIOpenData/CurveFault_A/vel3_1_31.npy
/projects/piml_inversion/FWIOpenData/CurveFault_A/seis4_1_0.npy	/projects/piml_inversion/FWIOpenData/CurveFault_A/vel4_1_0.npy
/projects/piml_inversion/FWIOpenData/CurveFault_A/seis4_1_1.npy	/projects/piml_inversion/FWIOpenData/CurveFault_A/vel4_1_1.npy
/projects/piml_inversion/FWIOpenData/CurveFault_A/seis4_1_2.npy	/projects/piml_inversion/FWIOpenData/CurveFault_A/vel4_1_2.npy
/projects/piml_inversion/FWIOpenData/CurveFault_A/seis4_1_3.npy	/projects/piml_inversion/FWIOpenData/CurveFault_A/vel4_1_3.npy
/projects/piml_inversion/FWIOpenData/CurveFault_A/seis4_1_4.npy	/projects/piml_inversion/FWIOpenData/CurveFault_A/vel4_1_4.npy
/projects/piml_inversion/FWIOpenData/CurveFault_A/seis4_1_5.npy	/projects/piml_inversion/FWIOpenData/CurveFault_A/vel4_1_5.npy
/projects/piml_inversion/FWIOpenData/CurveFault_A/seis4_1_6.npy	/projects/piml_inversion/FWIOpenData/CurveFault_A/vel4_1_6.npy
/projects/piml_inversion/FWIOpenData/CurveFault_A/seis4_1_7.npy	/projects/piml_inversion/FWIOpenData/CurveFault_A/vel4_1_7.npy
/projects/piml_inversion/FWIOpenData/CurveFault_A/seis4_1_8.npy	/projects/piml_inversion/FWIOpenData/CurveFault_A/vel4_1_8.npy
/projects/piml_inversion/FWIOpenData/CurveFault_A/seis4_1_9.npy	/projects/piml_inversion/FWIOpenData/CurveFault_A/vel4_1_9.npy
/projects/piml_inversion/FWIOpenData/CurveFault_A/seis4_1_10.npy	/projects/piml_inversion/FWIOpenData/CurveFault_A/vel4_1_10.npy
/projects/piml_inversion/FWIOpenData/CurveFault_A/seis4_1_11.npy	/projects/piml_inversion/FWIOpenData/CurveFault_A/vel4_1_11.npy
/projects/piml_inversion/FWIOpenData/CurveFault_A/seis4_1_12.npy	/projects/piml_inversion/FWIOpenData/CurveFault_A/vel4_1_12.npy
/projects/piml_inversion/FWIOpenData/CurveFault_A/seis4_1_13.npy	/projects/piml_inversion/FWIOpenData/CurveFault_A/vel4_1_13.npy
/projects/piml_inversion/FWIOpenData/CurveFault_A/seis4_1_14.npy	/projects/piml_inversion/FWIOpenData/CurveFault_A/vel4_1_14.npy
/projects/piml_inversion/FWIOpenData/CurveFault_A/seis4_1_15.npy	/projects/piml_inversion/FWIOpenData/CurveFault_A/vel4_1_15.npy
/projects/piml_inversion/FWIOpenData/CurveFault_A/seis4_1_16.npy	/projects/piml_inversion/FWIOpenData/CurveFault_A/vel4_1_16.npy
/projects/piml_inversion/FWIOpenData/CurveFault_A/seis4_1_17.npy	/projects/piml_inversion/FWIOpenData/CurveFault_A/vel4_1_17.npy
/projects/piml_inversion/FWIOpenData/CurveFault_A/seis4_1_18.npy	/projects/piml_inversion/FWIOpenData/CurveFault_A/vel4_1_18.npy
/projects/piml_inversion/FWIOpenData/CurveFault_A/seis4_1_19.npy	/projects/piml_inversion/FWIOpenData/CurveFault_A/vel4_1_19.npy
/projects/piml_inversion/FWIOpenData/CurveFault_A/seis4_1_20.npy	/projects/piml_inversion/FWIOpenData/CurveFault_A/vel4_1_20.npy
/projects/piml_inversion/FWIOpenData/CurveFault_A/seis4_1_21.npy	/projects/piml_inversion/FWIOpenData/CurveFault_A/vel4_1_21.npy
/projects/piml_inversion/FWIOpenData/CurveFault_A/seis4_1_22.npy	/projects/piml_inversion/FWIOpenData/CurveFault_A/vel4_1_22.npy
/projects/piml_inversion/FWIOpenData/CurveFault_A/seis4_1_23.npy	/projects/piml_inversion/FWIOpenData/CurveFault_A/vel4_1_23.npy
/projects/piml_inversion/FWIOpenData/CurveFault_A/seis4_1_24.npy	/projects/piml_inversion/FWIOpenData/CurveFault_A/vel4_1_24.npy
/projects/piml_inversion/FWIOpenData/CurveFault_A/seis4_1_25.npy	/projects/piml_inversion/FWIOpenData/CurveFault_A/vel4_1_25.npy
/projects/piml_inversion/FWIOpenData/CurveFault_A/seis4_1_26.npy	/projects/piml_inversion/FWIOpenData/CurveFault_A/vel4_1_26.npy
/projects/piml_inversion/FWIOpenData/CurveFault_A/seis4_1_27.npy	/projects/piml_inversion/FWIOpenData/CurveFault_A/vel4_1_27.npy
/projects/piml_inversion/FWIOpenData/CurveFault_A/seis4_1_28.npy	/projects/piml_inversion/FWIOpenData/CurveFault_A/vel4_1_28.npy
/projects/piml_inversion/FWIOpenData/CurveFault_A/seis4_1_29.npy	/projects/piml_inversion/FWIOpenData/CurveFault_A/vel4_1_29.npy
/projects/piml_inversion/FWIOpenData/CurveFault_A/seis4_1_30.npy	/projects/piml_inversion/FWIOpenData/CurveFault_A/vel4_1_30.npy
/projects/piml_inversion/FWIOpenData/CurveFault_A/seis4_1_31.npy	/projects/piml_inversion/FWIOpenData/CurveFault_A/vel4_1_31.npy
