/projects/piml_inversion/FWIOpenData/CurveFault_B/seis6_1_0.npy	/projects/piml_inversion/FWIOpenData/CurveFault_B/vel6_1_0.npy
/projects/piml_inversion/FWIOpenData/CurveFault_B/seis6_1_1.npy	/projects/piml_inversion/FWIOpenData/CurveFault_B/vel6_1_1.npy
/projects/piml_inversion/FWIOpenData/CurveFault_B/seis6_1_2.npy	/projects/piml_inversion/FWIOpenData/CurveFault_B/vel6_1_2.npy
/projects/piml_inversion/FWIOpenData/CurveFault_B/seis6_1_3.npy	/projects/piml_inversion/FWIOpenData/CurveFault_B/vel6_1_3.npy
/projects/piml_inversion/FWIOpenData/CurveFault_B/seis6_1_4.npy	/projects/piml_inversion/FWIOpenData/CurveFault_B/vel6_1_4.npy
/projects/piml_inversion/FWIOpenData/CurveFault_B/seis6_1_5.npy	/projects/piml_inversion/FWIOpenData/CurveFault_B/vel6_1_5.npy
/projects/piml_inversion/FWIOpenData/CurveFault_B/seis6_1_6.npy	/projects/piml_inversion/FWIOpenData/CurveFault_B/vel6_1_6.npy
/projects/piml_inversion/FWIOpenData/CurveFault_B/seis6_1_7.npy	/projects/piml_inversion/FWIOpenData/CurveFault_B/vel6_1_7.npy
/projects/piml_inversion/FWIOpenData/CurveFault_B/seis6_1_8.npy	/projects/piml_inversion/FWIOpenData/CurveFault_B/vel6_1_8.npy
/projects/piml_inversion/FWIOpenData/CurveFault_B/seis6_1_9.npy	/projects/piml_inversion/FWIOpenData/CurveFault_B/vel6_1_9.npy
/projects/piml_inversion/FWIOpenData/CurveFault_B/seis6_1_10.npy	/projects/piml_inversion/FWIOpenData/CurveFault_B/vel6_1_10.npy
/projects/piml_inversion/FWIOpenData/CurveFault_B/seis6_1_11.npy	/projects/piml_inversion/FWIOpenData/CurveFault_B/vel6_1_11.npy
/projects/piml_inversion/FWIOpenData/CurveFault_B/seis6_1_12.npy	/projects/piml_inversion/FWIOpenData/CurveFault_B/vel6_1_12.npy
/projects/piml_inversion/FWIOpenData/CurveFault_B/seis6_1_13.npy	/projects/piml_inversion/FWIOpenData/CurveFault_B/vel6_1_13.npy
/projects/piml_inversion/FWIOpenData/CurveFault_B/seis6_1_14.npy	/projects/piml_inversion/FWIOpenData/CurveFault_B/vel6_1_14.npy
/projects/piml_inversion/FWIOpenData/CurveFault_B/seis6_1_15.npy	/projects/piml_inversion/FWIOpenData/CurveFault_B/vel6_1_15.npy
/projects/piml_inversion/FWIOpenData/CurveFault_B/seis6_1_16.npy	/projects/piml_inversion/FWIOpenData/CurveFault_B/vel6_1_16.npy
/projects/piml_inversion/FWIOpenData/CurveFault_B/seis6_1_17.npy	/projects/piml_inversion/FWIOpenData/CurveFault_B/vel6_1_17.npy
/projects/piml_inversion/FWIOpenData/CurveFault_B/seis6_1_18.npy	/projects/piml_inversion/FWIOpenData/CurveFault_B/vel6_1_18.npy
/projects/piml_inversion/FWIOpenData/CurveFault_B/seis6_1_19.npy	/projects/piml_inversion/FWIOpenData/CurveFault_B/vel6_1_19.npy
/projects/piml_inversion/FWIOpenData/CurveFault_B/seis6_1_20.npy	/projects/piml_inversion/FWIOpenData/CurveFault_B/vel6_1_20.npy
/projects/piml_inversion/FWIOpenData/CurveFault_B/seis6_1_21.npy	/projects/piml_inversion/FWIOpenData/CurveFault_B/vel6_1_21.npy
/projects/piml_inversion/FWIOpenData/CurveFault_B/seis6_1_22.npy	/projects/piml_inversion/FWIOpenData/CurveFault_B/vel6_1_22.npy
/projects/piml_inversion/FWIOpenData/CurveFault_B/seis6_1_23.npy	/projects/piml_inversion/FWIOpenData/CurveFault_B/vel6_1_23.npy
/projects/piml_inversion/FWIOpenData/CurveFault_B/seis6_1_24.npy	/projects/piml_inversion/FWIOpenData/CurveFault_B/vel6_1_24.npy
/projects/piml_inversion/FWIOpenData/CurveFault_B/seis6_1_25.npy	/projects/piml_inversion/FWIOpenData/CurveFault_B/vel6_1_25.npy
/projects/piml_inversion/FWIOpenData/CurveFault_B/seis6_1_26.npy	/projects/piml_inversion/FWIOpenData/CurveFault_B/vel6_1_26.npy
/projects/piml_inversion/FWIOpenData/CurveFault_B/seis6_1_27.npy	/projects/piml_inversion/FWIOpenData/CurveFault_B/vel6_1_27.npy
/projects/piml_inversion/FWIOpenData/CurveFault_B/seis6_1_28.npy	/projects/piml_inversion/FWIOpenData/CurveFault_B/vel6_1_28.npy
/projects/piml_inversion/FWIOpenData/CurveFault_B/seis6_1_29.npy	/projects/piml_inversion/FWIOpenData/CurveFault_B/vel6_1_29.npy
/projects/piml_inversion/FWIOpenData/CurveFault_B/seis6_1_30.npy	/projects/piml_inversion/FWIOpenData/CurveFault_B/vel6_1_30.npy
/projects/piml_inversion/FWIOpenData/CurveFault_B/seis6_1_31.npy	/projects/piml_inversion/FWIOpenData/CurveFault_B/vel6_1_31.npy
/projects/piml_inversion/FWIOpenData/CurveFault_B/seis7_1_0.npy	/projects/piml_inversion/FWIOpenData/CurveFault_B/vel7_1_0.npy
/projects/piml_inversion/FWIOpenData/CurveFault_B/seis7_1_1.npy	/projects/piml_inversion/FWIOpenData/CurveFault_B/vel7_1_1.npy
/projects/piml_inversion/FWIOpenData/CurveFault_B/seis7_1_2.npy	/projects/piml_inversion/FWIOpenData/CurveFault_B/vel7_1_2.npy
/projects/piml_inversion/FWIOpenData/CurveFault_B/seis7_1_3.npy	/projects/piml_inversion/FWIOpenData/CurveFault_B/vel7_1_3.npy
/projects/piml_inversion/FWIOpenData/CurveFault_B/seis7_1_4.npy	/projects/piml_inversion/FWIOpenData/CurveFault_B/vel7_1_4.npy
/projects/piml_inversion/FWIOpenData/CurveFault_B/seis7_1_5.npy	/projects/piml_inversion/FWIOpenData/CurveFault_B/vel7_1_5.npy
/projects/piml_inversion/FWIOpenData/CurveFault_B/seis7_1_6.npy	/projects/piml_inversion/FWIOpenData/CurveFault_B/vel7_1_6.npy
/projects/piml_inversion/FWIOpenData/CurveFault_B/seis7_1_7.npy	/projects/piml_inversion/FWIOpenData/CurveFault_B/vel7_1_7.npy
/projects/piml_inversion/FWIOpenData/CurveFault_B/seis7_1_8.npy	/projects/piml_inversion/FWIOpenData/CurveFault_B/vel7_1_8.npy
/projects/piml_inversion/FWIOpenData/CurveFault_B/seis7_1_9.npy	/projects/piml_inversion/FWIOpenData/CurveFault_B/vel7_1_9.npy
/projects/piml_inversion/FWIOpenData/CurveFault_B/seis7_1_10.npy	/projects/piml_inversion/FWIOpenData/CurveFault_B/vel7_1_10.npy
/projects/piml_inversion/FWIOpenData/CurveFault_B/seis7_1_11.npy	/projects/piml_inversion/FWIOpenData/CurveFault_B/vel7_1_11.npy
/projects/piml_inversion/FWIOpenData/CurveFault_B/seis7_1_12.npy	/projects/piml_inversion/FWIOpenData/CurveFault_B/vel7_1_12.npy
/projects/piml_inversion/FWIOpenData/CurveFault_B/seis7_1_13.npy	/projects/piml_inversion/FWIOpenData/CurveFault_B/vel7_1_13.npy
/projects/piml_inversion/FWIOpenData/CurveFault_B/seis7_1_14.npy	/projects/piml_inversion/FWIOpenData/CurveFault_B/vel7_1_14.npy
/projects/piml_inversion/FWIOpenData/CurveFault_B/seis7_1_15.npy	/projects/piml_inversion/FWIOpenData/CurveFault_B/vel7_1_15.npy
/projects/piml_inversion/FWIOpenData/CurveFault_B/seis7_1_16.npy	/projects/piml_inversion/FWIOpenData/CurveFault_B/vel7_1_16.npy
/projects/piml_inversion/FWIOpenData/CurveFault_B/seis7_1_17.npy	/projects/piml_inversion/FWIOpenData/CurveFault_B/vel7_1_17.npy
/projects/piml_inversion/FWIOpenData/CurveFault_B/seis7_1_18.npy	/projects/piml_inversion/FWIOpenData/CurveFault_B/vel7_1_18.npy
/projects/piml_inversion/FWIOpenData/CurveFault_B/seis7_1_19.npy	/projects/piml_inversion/FWIOpenData/CurveFault_B/vel7_1_19.npy
/projects/piml_inversion/FWIOpenData/CurveFault_B/seis7_1_20.npy	/projects/piml_inversion/FWIOpenData/CurveFault_B/vel7_1_20.npy
/projects/piml_inversion/FWIOpenData/CurveFault_B/seis7_1_21.npy	/projects/piml_inversion/FWIOpenData/CurveFault_B/vel7_1_21.npy
/projects/piml_inversion/FWIOpenData/CurveFault_B/seis7_1_22.npy	/projects/piml_inversion/FWIOpenData/CurveFault_B/vel7_1_22.npy
/projects/piml_inversion/FWIOpenData/CurveFault_B/seis7_1_23.npy	/projects/piml_inversion/FWIOpenData/CurveFault_B/vel7_1_23.npy
/projects/piml_inversion/FWIOpenData/CurveFault_B/seis7_1_24.npy	/projects/piml_inversion/FWIOpenData/CurveFault_B/vel7_1_24.npy
/projects/piml_inversion/FWIOpenData/CurveFault_B/seis7_1_25.npy	/projects/piml_inversion/FWIOpenData/CurveFault_B/vel7_1_25.npy
/projects/piml_inversion/FWIOpenData/CurveFault_B/seis7_1_26.npy	/projects/piml_inversion/FWIOpenData/CurveFault_B/vel7_1_26.npy
/projects/piml_inversion/FWIOpenData/CurveFault_B/seis7_1_27.npy	/projects/piml_inversion/FWIOpenData/CurveFault_B/vel7_1_27.npy
/projects/piml_inversion/FWIOpenData/CurveFault_B/seis7_1_28.npy	/projects/piml_inversion/FWIOpenData/CurveFault_B/vel7_1_28.npy
/projects/piml_inversion/FWIOpenData/CurveFault_B/seis7_1_29.npy	/projects/piml_inversion/FWIOpenData/CurveFault_B/vel7_1_29.npy
/projects/piml_inversion/FWIOpenData/CurveFault_B/seis7_1_30.npy	/projects/piml_inversion/FWIOpenData/CurveFault_B/vel7_1_30.npy
/projects/piml_inversion/FWIOpenData/CurveFault_B/seis7_1_31.npy	/projects/piml_inversion/FWIOpenData/CurveFault_B/vel7_1_31.npy
/projects/piml_inversion/FWIOpenData/CurveFault_B/seis8_1_0.npy	/projects/piml_inversion/FWIOpenData/CurveFault_B/vel8_1_0.npy
/projects/piml_inversion/FWIOpenData/CurveFault_B/seis8_1_1.npy	/projects/piml_inversion/FWIOpenData/CurveFault_B/vel8_1_1.npy
/projects/piml_inversion/FWIOpenData/CurveFault_B/seis8_1_2.npy	/projects/piml_inversion/FWIOpenData/CurveFault_B/vel8_1_2.npy
/projects/piml_inversion/FWIOpenData/CurveFault_B/seis8_1_3.npy	/projects/piml_inversion/FWIOpenData/CurveFault_B/vel8_1_3.npy
/projects/piml_inversion/FWIOpenData/CurveFault_B/seis8_1_4.npy	/projects/piml_inversion/FWIOpenData/CurveFault_B/vel8_1_4.npy
/projects/piml_inversion/FWIOpenData/CurveFault_B/seis8_1_5.npy	/projects/piml_inversion/FWIOpenData/CurveFault_B/vel8_1_5.npy
/projects/piml_inversion/FWIOpenData/CurveFault_B/seis8_1_6.npy	/projects/piml_inversion/FWIOpenData/CurveFault_B/vel8_1_6.npy
/projects/piml_inversion/FWIOpenData/CurveFault_B/seis8_1_7.npy	/projects/piml_inversion/FWIOpenData/CurveFault_B/vel8_1_7.npy
/projects/piml_inversion/FWIOpenData/CurveFault_B/seis8_1_8.npy	/projects/piml_inversion/FWIOpenData/CurveFault_B/vel8_1_8.npy
/projects/piml_inversion/FWIOpenData/CurveFault_B/seis8_1_9.npy	/projects/piml_inversion/FWIOpenData/CurveFault_B/vel8_1_9.npy
/projects/piml_inversion/FWIOpenData/CurveFault_B/seis8_1_10.npy	/projects/piml_inversion/FWIOpenData/CurveFault_B/vel8_1_10.npy
/projects/piml_inversion/FWIOpenData/CurveFault_B/seis8_1_11.npy	/projects/piml_inversion/FWIOpenData/CurveFault_B/vel8_1_11.npy
/projects/piml_inversion/FWIOpenData/CurveFault_B/seis8_1_12.npy	/projects/piml_inversion/FWIOpenData/CurveFault_B/vel8_1_12.npy
/projects/piml_inversion/FWIOpenData/CurveFault_B/seis8_1_13.npy	/projects/piml_inversion/FWIOpenData/CurveFault_B/vel8_1_13.npy
/projects/piml_inversion/FWIOpenData/CurveFault_B/seis8_1_14.npy	/projects/piml_inversion/FWIOpenData/CurveFault_B/vel8_1_14.npy
/projects/piml_inversion/FWIOpenData/CurveFault_B/seis8_1_15.npy	/projects/piml_inversion/FWIOpenData/CurveFault_B/vel8_1_15.npy
/projects/piml_inversion/FWIOpenData/CurveFault_B/seis8_1_16.npy	/projects/piml_inversion/FWIOpenData/CurveFault_B/vel8_1_16.npy
/projects/piml_inversion/FWIOpenData/CurveFault_B/seis8_1_17.npy	/projects/piml_inversion/FWIOpenData/CurveFault_B/vel8_1_17.npy
/projects/piml_inversion/FWIOpenData/CurveFault_B/seis8_1_18.npy	/projects/piml_inversion/FWIOpenData/CurveFault_B/vel8_1_18.npy
/projects/piml_inversion/FWIOpenData/CurveFault_B/seis8_1_19.npy	/projects/piml_inversion/FWIOpenData/CurveFault_B/vel8_1_19.npy
/projects/piml_inversion/FWIOpenData/CurveFault_B/seis8_1_20.npy	/projects/piml_inversion/FWIOpenData/CurveFault_B/vel8_1_20.npy
/projects/piml_inversion/FWIOpenData/CurveFault_B/seis8_1_21.npy	/projects/piml_inversion/FWIOpenData/CurveFault_B/vel8_1_21.npy
/projects/piml_inversion/FWIOpenData/CurveFault_B/seis8_1_22.npy	/projects/piml_inversion/FWIOpenData/CurveFault_B/vel8_1_22.npy
/projects/piml_inversion/FWIOpenData/CurveFault_B/seis8_1_23.npy	/projects/piml_inversion/FWIOpenData/CurveFault_B/vel8_1_23.npy
/projects/piml_inversion/FWIOpenData/CurveFault_B/seis8_1_24.npy	/projects/piml_inversion/FWIOpenData/CurveFault_B/vel8_1_24.npy
/projects/piml_inversion/FWIOpenData/CurveFault_B/seis8_1_25.npy	/projects/piml_inversion/FWIOpenData/CurveFault_B/vel8_1_25.npy
/projects/piml_inversion/FWIOpenData/CurveFault_B/seis8_1_26.npy	/projects/piml_inversion/FWIOpenData/CurveFault_B/vel8_1_26.npy
/projects/piml_inversion/FWIOpenData/CurveFault_B/seis8_1_27.npy	/projects/piml_inversion/FWIOpenData/CurveFault_B/vel8_1_27.npy
/projects/piml_inversion/FWIOpenData/CurveFault_B/seis8_1_28.npy	/projects/piml_inversion/FWIOpenData/CurveFault_B/vel8_1_28.npy
/projects/piml_inversion/FWIOpenData/CurveFault_B/seis8_1_29.npy	/projects/piml_inversion/FWIOpenData/CurveFault_B/vel8_1_29.npy
/projects/piml_inversion/FWIOpenData/CurveFault_B/seis8_1_30.npy	/projects/piml_inversion/FWIOpenData/CurveFault_B/vel8_1_30.npy
/projects/piml_inversion/FWIOpenData/CurveFault_B/seis8_1_31.npy	/projects/piml_inversion/FWIOpenData/CurveFault_B/vel8_1_31.npy
