/projects/piml_inversion/FWIOpenData/Style_B/data/data1.npy	/projects/piml_inversion/FWIOpenData/Style_B/model/model1.npy
/projects/piml_inversion/FWIOpenData/Style_B/data/data2.npy	/projects/piml_inversion/FWIOpenData/Style_B/model/model2.npy
/projects/piml_inversion/FWIOpenData/Style_B/data/data3.npy	/projects/piml_inversion/FWIOpenData/Style_B/model/model3.npy
/projects/piml_inversion/FWIOpenData/Style_B/data/data4.npy	/projects/piml_inversion/FWIOpenData/Style_B/model/model4.npy
/projects/piml_inversion/FWIOpenData/Style_B/data/data5.npy	/projects/piml_inversion/FWIOpenData/Style_B/model/model5.npy
/projects/piml_inversion/FWIOpenData/Style_B/data/data6.npy	/projects/piml_inversion/FWIOpenData/Style_B/model/model6.npy
/projects/piml_inversion/FWIOpenData/Style_B/data/data7.npy	/projects/piml_inversion/FWIOpenData/Style_B/model/model7.npy
/projects/piml_inversion/FWIOpenData/Style_B/data/data8.npy	/projects/piml_inversion/FWIOpenData/Style_B/model/model8.npy
/projects/piml_inversion/FWIOpenData/Style_B/data/data9.npy	/projects/piml_inversion/FWIOpenData/Style_B/model/model9.npy
/projects/piml_inversion/FWIOpenData/Style_B/data/data10.npy	/projects/piml_inversion/FWIOpenData/Style_B/model/model10.npy
/projects/piml_inversion/FWIOpenData/Style_B/data/data11.npy	/projects/piml_inversion/FWIOpenData/Style_B/model/model11.npy
/projects/piml_inversion/FWIOpenData/Style_B/data/data12.npy	/projects/piml_inversion/FWIOpenData/Style_B/model/model12.npy
/projects/piml_inversion/FWIOpenData/Style_B/data/data13.npy	/projects/piml_inversion/FWIOpenData/Style_B/model/model13.npy
/projects/piml_inversion/FWIOpenData/Style_B/data/data14.npy	/projects/piml_inversion/FWIOpenData/Style_B/model/model14.npy
/projects/piml_inversion/FWIOpenData/Style_B/data/data15.npy	/projects/piml_inversion/FWIOpenData/Style_B/model/model15.npy
/projects/piml_inversion/FWIOpenData/Style_B/data/data16.npy	/projects/piml_inversion/FWIOpenData/Style_B/model/model16.npy
/projects/piml_inversion/FWIOpenData/Style_B/data/data17.npy	/projects/piml_inversion/FWIOpenData/Style_B/model/model17.npy
/projects/piml_inversion/FWIOpenData/Style_B/data/data18.npy	/projects/piml_inversion/FWIOpenData/Style_B/model/model18.npy
/projects/piml_inversion/FWIOpenData/Style_B/data/data19.npy	/projects/piml_inversion/FWIOpenData/Style_B/model/model19.npy
/projects/piml_inversion/FWIOpenData/Style_B/data/data20.npy	/projects/piml_inversion/FWIOpenData/Style_B/model/model20.npy
/projects/piml_inversion/FWIOpenData/Style_B/data/data21.npy	/projects/piml_inversion/FWIOpenData/Style_B/model/model21.npy
/projects/piml_inversion/FWIOpenData/Style_B/data/data22.npy	/projects/piml_inversion/FWIOpenData/Style_B/model/model22.npy
/projects/piml_inversion/FWIOpenData/Style_B/data/data23.npy	/projects/piml_inversion/FWIOpenData/Style_B/model/model23.npy
/projects/piml_inversion/FWIOpenData/Style_B/data/data24.npy	/projects/piml_inversion/FWIOpenData/Style_B/model/model24.npy
/projects/piml_inversion/FWIOpenData/Style_B/data/data25.npy	/projects/piml_inversion/FWIOpenData/Style_B/model/model25.npy
/projects/piml_inversion/FWIOpenData/Style_B/data/data26.npy	/projects/piml_inversion/FWIOpenData/Style_B/model/model26.npy
/projects/piml_inversion/FWIOpenData/Style_B/data/data27.npy	/projects/piml_inversion/FWIOpenData/Style_B/model/model27.npy
/projects/piml_inversion/FWIOpenData/Style_B/data/data28.npy	/projects/piml_inversion/FWIOpenData/Style_B/model/model28.npy
/projects/piml_inversion/FWIOpenData/Style_B/data/data29.npy	/projects/piml_inversion/FWIOpenData/Style_B/model/model29.npy
/projects/piml_inversion/FWIOpenData/Style_B/data/data30.npy	/projects/piml_inversion/FWIOpenData/Style_B/model/model30.npy
/projects/piml_inversion/FWIOpenData/Style_B/data/data31.npy	/projects/piml_inversion/FWIOpenData/Style_B/model/model31.npy
/projects/piml_inversion/FWIOpenData/Style_B/data/data32.npy	/projects/piml_inversion/FWIOpenData/Style_B/model/model32.npy
/projects/piml_inversion/FWIOpenData/Style_B/data/data33.npy	/projects/piml_inversion/FWIOpenData/Style_B/model/model33.npy
/projects/piml_inversion/FWIOpenData/Style_B/data/data34.npy	/projects/piml_inversion/FWIOpenData/Style_B/model/model34.npy
/projects/piml_inversion/FWIOpenData/Style_B/data/data35.npy	/projects/piml_inversion/FWIOpenData/Style_B/model/model35.npy
/projects/piml_inversion/FWIOpenData/Style_B/data/data36.npy	/projects/piml_inversion/FWIOpenData/Style_B/model/model36.npy
/projects/piml_inversion/FWIOpenData/Style_B/data/data37.npy	/projects/piml_inversion/FWIOpenData/Style_B/model/model37.npy
/projects/piml_inversion/FWIOpenData/Style_B/data/data38.npy	/projects/piml_inversion/FWIOpenData/Style_B/model/model38.npy
/projects/piml_inversion/FWIOpenData/Style_B/data/data39.npy	/projects/piml_inversion/FWIOpenData/Style_B/model/model39.npy
/projects/piml_inversion/FWIOpenData/Style_B/data/data40.npy	/projects/piml_inversion/FWIOpenData/Style_B/model/model40.npy
/projects/piml_inversion/FWIOpenData/Style_B/data/data41.npy	/projects/piml_inversion/FWIOpenData/Style_B/model/model41.npy
/projects/piml_inversion/FWIOpenData/Style_B/data/data42.npy	/projects/piml_inversion/FWIOpenData/Style_B/model/model42.npy
/projects/piml_inversion/FWIOpenData/Style_B/data/data43.npy	/projects/piml_inversion/FWIOpenData/Style_B/model/model43.npy
/projects/piml_inversion/FWIOpenData/Style_B/data/data44.npy	/projects/piml_inversion/FWIOpenData/Style_B/model/model44.npy
/projects/piml_inversion/FWIOpenData/Style_B/data/data45.npy	/projects/piml_inversion/FWIOpenData/Style_B/model/model45.npy
/projects/piml_inversion/FWIOpenData/Style_B/data/data46.npy	/projects/piml_inversion/FWIOpenData/Style_B/model/model46.npy
/projects/piml_inversion/FWIOpenData/Style_B/data/data47.npy	/projects/piml_inversion/FWIOpenData/Style_B/model/model47.npy
/projects/piml_inversion/FWIOpenData/Style_B/data/data48.npy	/projects/piml_inversion/FWIOpenData/Style_B/model/model48.npy
/projects/piml_inversion/FWIOpenData/Style_B/data/data49.npy	/projects/piml_inversion/FWIOpenData/Style_B/model/model49.npy
/projects/piml_inversion/FWIOpenData/Style_B/data/data50.npy	/projects/piml_inversion/FWIOpenData/Style_B/model/model50.npy
/projects/piml_inversion/FWIOpenData/Style_B/data/data51.npy	/projects/piml_inversion/FWIOpenData/Style_B/model/model51.npy
/projects/piml_inversion/FWIOpenData/Style_B/data/data52.npy	/projects/piml_inversion/FWIOpenData/Style_B/model/model52.npy
/projects/piml_inversion/FWIOpenData/Style_B/data/data53.npy	/projects/piml_inversion/FWIOpenData/Style_B/model/model53.npy
/projects/piml_inversion/FWIOpenData/Style_B/data/data54.npy	/projects/piml_inversion/FWIOpenData/Style_B/model/model54.npy
/projects/piml_inversion/FWIOpenData/Style_B/data/data55.npy	/projects/piml_inversion/FWIOpenData/Style_B/model/model55.npy
/projects/piml_inversion/FWIOpenData/Style_B/data/data56.npy	/projects/piml_inversion/FWIOpenData/Style_B/model/model56.npy
/projects/piml_inversion/FWIOpenData/Style_B/data/data57.npy	/projects/piml_inversion/FWIOpenData/Style_B/model/model57.npy
/projects/piml_inversion/FWIOpenData/Style_B/data/data58.npy	/projects/piml_inversion/FWIOpenData/Style_B/model/model58.npy
/projects/piml_inversion/FWIOpenData/Style_B/data/data59.npy	/projects/piml_inversion/FWIOpenData/Style_B/model/model59.npy
/projects/piml_inversion/FWIOpenData/Style_B/data/data60.npy	/projects/piml_inversion/FWIOpenData/Style_B/model/model60.npy
/projects/piml_inversion/FWIOpenData/Style_B/data/data61.npy	/projects/piml_inversion/FWIOpenData/Style_B/model/model61.npy
/projects/piml_inversion/FWIOpenData/Style_B/data/data62.npy	/projects/piml_inversion/FWIOpenData/Style_B/model/model62.npy
/projects/piml_inversion/FWIOpenData/Style_B/data/data63.npy	/projects/piml_inversion/FWIOpenData/Style_B/model/model63.npy
/projects/piml_inversion/FWIOpenData/Style_B/data/data64.npy	/projects/piml_inversion/FWIOpenData/Style_B/model/model64.npy
/projects/piml_inversion/FWIOpenData/Style_B/data/data65.npy	/projects/piml_inversion/FWIOpenData/Style_B/model/model65.npy
/projects/piml_inversion/FWIOpenData/Style_B/data/data66.npy	/projects/piml_inversion/FWIOpenData/Style_B/model/model66.npy
/projects/piml_inversion/FWIOpenData/Style_B/data/data67.npy	/projects/piml_inversion/FWIOpenData/Style_B/model/model67.npy
/projects/piml_inversion/FWIOpenData/Style_B/data/data68.npy	/projects/piml_inversion/FWIOpenData/Style_B/model/model68.npy
/projects/piml_inversion/FWIOpenData/Style_B/data/data69.npy	/projects/piml_inversion/FWIOpenData/Style_B/model/model69.npy
/projects/piml_inversion/FWIOpenData/Style_B/data/data70.npy	/projects/piml_inversion/FWIOpenData/Style_B/model/model70.npy
/projects/piml_inversion/FWIOpenData/Style_B/data/data71.npy	/projects/piml_inversion/FWIOpenData/Style_B/model/model71.npy
/projects/piml_inversion/FWIOpenData/Style_B/data/data72.npy	/projects/piml_inversion/FWIOpenData/Style_B/model/model72.npy
/projects/piml_inversion/FWIOpenData/Style_B/data/data73.npy	/projects/piml_inversion/FWIOpenData/Style_B/model/model73.npy
/projects/piml_inversion/FWIOpenData/Style_B/data/data74.npy	/projects/piml_inversion/FWIOpenData/Style_B/model/model74.npy
/projects/piml_inversion/FWIOpenData/Style_B/data/data75.npy	/projects/piml_inversion/FWIOpenData/Style_B/model/model75.npy
/projects/piml_inversion/FWIOpenData/Style_B/data/data76.npy	/projects/piml_inversion/FWIOpenData/Style_B/model/model76.npy
/projects/piml_inversion/FWIOpenData/Style_B/data/data77.npy	/projects/piml_inversion/FWIOpenData/Style_B/model/model77.npy
/projects/piml_inversion/FWIOpenData/Style_B/data/data78.npy	/projects/piml_inversion/FWIOpenData/Style_B/model/model78.npy
/projects/piml_inversion/FWIOpenData/Style_B/data/data79.npy	/projects/piml_inversion/FWIOpenData/Style_B/model/model79.npy
/projects/piml_inversion/FWIOpenData/Style_B/data/data80.npy	/projects/piml_inversion/FWIOpenData/Style_B/model/model80.npy
/projects/piml_inversion/FWIOpenData/Style_B/data/data81.npy	/projects/piml_inversion/FWIOpenData/Style_B/model/model81.npy
/projects/piml_inversion/FWIOpenData/Style_B/data/data82.npy	/projects/piml_inversion/FWIOpenData/Style_B/model/model82.npy
/projects/piml_inversion/FWIOpenData/Style_B/data/data83.npy	/projects/piml_inversion/FWIOpenData/Style_B/model/model83.npy
/projects/piml_inversion/FWIOpenData/Style_B/data/data84.npy	/projects/piml_inversion/FWIOpenData/Style_B/model/model84.npy
/projects/piml_inversion/FWIOpenData/Style_B/data/data85.npy	/projects/piml_inversion/FWIOpenData/Style_B/model/model85.npy
/projects/piml_inversion/FWIOpenData/Style_B/data/data86.npy	/projects/piml_inversion/FWIOpenData/Style_B/model/model86.npy
/projects/piml_inversion/FWIOpenData/Style_B/data/data87.npy	/projects/piml_inversion/FWIOpenData/Style_B/model/model87.npy
/projects/piml_inversion/FWIOpenData/Style_B/data/data88.npy	/projects/piml_inversion/FWIOpenData/Style_B/model/model88.npy
/projects/piml_inversion/FWIOpenData/Style_B/data/data89.npy	/projects/piml_inversion/FWIOpenData/Style_B/model/model89.npy
/projects/piml_inversion/FWIOpenData/Style_B/data/data90.npy	/projects/piml_inversion/FWIOpenData/Style_B/model/model90.npy
/projects/piml_inversion/FWIOpenData/Style_B/data/data91.npy	/projects/piml_inversion/FWIOpenData/Style_B/model/model91.npy
/projects/piml_inversion/FWIOpenData/Style_B/data/data92.npy	/projects/piml_inversion/FWIOpenData/Style_B/model/model92.npy
/projects/piml_inversion/FWIOpenData/Style_B/data/data93.npy	/projects/piml_inversion/FWIOpenData/Style_B/model/model93.npy
/projects/piml_inversion/FWIOpenData/Style_B/data/data94.npy	/projects/piml_inversion/FWIOpenData/Style_B/model/model94.npy
/projects/piml_inversion/FWIOpenData/Style_B/data/data95.npy	/projects/piml_inversion/FWIOpenData/Style_B/model/model95.npy
/projects/piml_inversion/FWIOpenData/Style_B/data/data96.npy	/projects/piml_inversion/FWIOpenData/Style_B/model/model96.npy
/projects/piml_inversion/FWIOpenData/Style_B/data/data97.npy	/projects/piml_inversion/FWIOpenData/Style_B/model/model97.npy
/projects/piml_inversion/FWIOpenData/Style_B/data/data98.npy	/projects/piml_inversion/FWIOpenData/Style_B/model/model98.npy
/projects/piml_inversion/FWIOpenData/Style_B/data/data99.npy	/projects/piml_inversion/FWIOpenData/Style_B/model/model99.npy
/projects/piml_inversion/FWIOpenData/Style_B/data/data100.npy	/projects/piml_inversion/FWIOpenData/Style_B/model/model100.npy
/projects/piml_inversion/FWIOpenData/Style_B/data/data101.npy	/projects/piml_inversion/FWIOpenData/Style_B/model/model101.npy
/projects/piml_inversion/FWIOpenData/Style_B/data/data102.npy	/projects/piml_inversion/FWIOpenData/Style_B/model/model102.npy
/projects/piml_inversion/FWIOpenData/Style_B/data/data103.npy	/projects/piml_inversion/FWIOpenData/Style_B/model/model103.npy
/projects/piml_inversion/FWIOpenData/Style_B/data/data104.npy	/projects/piml_inversion/FWIOpenData/Style_B/model/model104.npy
/projects/piml_inversion/FWIOpenData/Style_B/data/data105.npy	/projects/piml_inversion/FWIOpenData/Style_B/model/model105.npy
/projects/piml_inversion/FWIOpenData/Style_B/data/data106.npy	/projects/piml_inversion/FWIOpenData/Style_B/model/model106.npy
/projects/piml_inversion/FWIOpenData/Style_B/data/data107.npy	/projects/piml_inversion/FWIOpenData/Style_B/model/model107.npy
/projects/piml_inversion/FWIOpenData/Style_B/data/data108.npy	/projects/piml_inversion/FWIOpenData/Style_B/model/model108.npy
/projects/piml_inversion/FWIOpenData/Style_B/data/data109.npy	/projects/piml_inversion/FWIOpenData/Style_B/model/model109.npy
/projects/piml_inversion/FWIOpenData/Style_B/data/data110.npy	/projects/piml_inversion/FWIOpenData/Style_B/model/model110.npy
/projects/piml_inversion/FWIOpenData/Style_B/data/data111.npy	/projects/piml_inversion/FWIOpenData/Style_B/model/model111.npy
/projects/piml_inversion/FWIOpenData/Style_B/data/data112.npy	/projects/piml_inversion/FWIOpenData/Style_B/model/model112.npy
/projects/piml_inversion/FWIOpenData/Style_B/data/data113.npy	/projects/piml_inversion/FWIOpenData/Style_B/model/model113.npy
/projects/piml_inversion/FWIOpenData/Style_B/data/data114.npy	/projects/piml_inversion/FWIOpenData/Style_B/model/model114.npy
/projects/piml_inversion/FWIOpenData/Style_B/data/data115.npy	/projects/piml_inversion/FWIOpenData/Style_B/model/model115.npy
/projects/piml_inversion/FWIOpenData/Style_B/data/data116.npy	/projects/piml_inversion/FWIOpenData/Style_B/model/model116.npy
/projects/piml_inversion/FWIOpenData/Style_B/data/data117.npy	/projects/piml_inversion/FWIOpenData/Style_B/model/model117.npy
/projects/piml_inversion/FWIOpenData/Style_B/data/data118.npy	/projects/piml_inversion/FWIOpenData/Style_B/model/model118.npy
/projects/piml_inversion/FWIOpenData/Style_B/data/data119.npy	/projects/piml_inversion/FWIOpenData/Style_B/model/model119.npy
/projects/piml_inversion/FWIOpenData/Style_B/data/data120.npy	/projects/piml_inversion/FWIOpenData/Style_B/model/model120.npy
